                        1111111111                                .
                        10000000001                               .
                        10000000001                               .
                         100000001                                .
11111    111111111111111111000001                                 .
10001    100000000000000000000001                                 .
10011111101111111111111111000001                                  .
10001    100000000000000001111111                                 .
11011    111111111111111101                           111111      .
100011111110000000000000001                          10000001     .
10001000011011111111111111111111111111111           1000000001    .
1000000001101               1000000000001          1000000000011  .
1000100001101               100000000000111111111110000000000001  .
100011111110111111          1000000000000000000000000000S0000001  .
100011000000000001          100000000000111111111110000000000001  .
100011000000000001          1000000000001          1000000000011  .
10001100000000000111111111111000000000001           1000000001    .
10001100000000000000000000000000011111111            10000001     .
10001100000000000111111111111110001                   111111      .
100001000000000001           10001                                .
100000000000000001           10001                                .
100001000000000001           10001                                .
100011000000000001           10001                                .
100011000000000001          10001                                 .
100011000000000001         10001                                  .
100011000000000001        10001                                   .
100011111111111111       10001                                    .
10001            11111  10001                                     .
1001          11100000110001                                      .
101         110000000000001                                       .
101        10000000000000001                                      .
101       1000000000000000001                                     .
101111111100000000000000000001                                    .
100000000000000000000000000001                                    .
111111111100000000000000000001                                    .
          1000000000000000001                                     .
           10000000000000001                                      .
            110000000000011                                       .
              11100000111                                         .
                 11111                                            .
...................................................................