111111111111 
100000000001 
100E000100001
100000100011 
11100010001  
11111111111  
