WE textures/wood_strips.xpm
SO textures/wood_box.xpm
EA textures/rakhsas-_1_.xpm
NO textures/rocks.xpm

F 220,100,0
C 225,30,0

1111111111111111111111111
1000000000110000000000001
1011000001110000N000000001
10010000000000000000000011111111
111111111011000001110000000000001
100000000011000001110111111111111
1111011111111101110000000001
11110111111111011101010010001
11000000110101011100000010001
10000000000000001100000010001
10000000000000001101010010001
110000011101010111110111100111
11110111 1110101 101111010001
11111111 1111111 111111111111