WE textures/wood_strips.xpm
SO textures/wood_box.xpm
EA textures/wood.xpm
NO textures/rocks.xpm


F 56,56,56
C 113,113,113


1111111111111111111111111
1000000000110000000000001
1011000001110000000000001
10010000000000000000000011111111
111111111011000001110000000000001
100000000011000001110111111111111
11110111111111011100000010001
11110111111111011101010010001
11000000110101011100000010001
10000000000000001100000010001
10000000000000001101000000001
1100000111010101111100N00111
11110111 1110101 100000010001
11111111 1111111 111111111111